15 28
............................
............................
............................
............................
............................
............................
............................
............................
............................
..................#.........
..................#.........
..................#.........
...#...C..........##........
.S.....##...##.C..######.C..
############################